#######################################################################
#                                                                     #
#                                                                     #
#                                                                     #
#                                                                     #
#                                                                     #
#                                                                     #
#                                                                     #
#                                                                     #
#                                                                     #
#                                                                     #
#                                                                     #
#                                            ..........               #
#                                                                     #
# H                     ..                                            #
#                                                                     #
#                                                                     #
#                         ......                                      #
#                                                                     #
#                           V                                         #
#                                                                     #
#                                                                     #
#                                                                     #
#######################################################################