#######################################################################
# .. .....................................................  ......    #
# V. %%%%%%%%%%%%%%%%        ...     %%%%%%%%%%%%%%  #%#..   %%%%     #
# ..        #%#   #%#     #%#...     #%#        #%#  #%#..    #%#     #
# ..        #%#   #%#     #%#...     #%#        #%#  #%#..    #%#     #
# ..        %%%%%%%%  . . #%#...     %%%%%%%%%%%%%%     ..   %%%%.    #
# ..        #%#       . . #%#...    ............... #%# ..       .    #
# ..        %%%%%%%%%%. . #%#...    %%%%%%%%%%%%    #%# ..   %%%%.    #
# ..               #%#.             #%#......       #%# ..    #%#.    #
# ..     ......... #%#.             #%#......#%#        ..    #%#.    #
# ..#%#  #%#%%%#%#.#%#. #%#            ......#%#        ..#%# #%#.    #
# ..#%#  #%#   #%#..    %%%%%%%%%%%%%  ......#%#         .#%#.        #
# ..#%#  ###   #%#..           ...#%#     %%%%%%        . #%#.        #
# ..#%#            .           ...#%#               #%# ..#%#.        #
# ..#%#  %%%%%%%%%%%%%%        ...#%#%%%%%%%%%%     #%# ..#%#%%%%%    #
# ...............................................   #%# ..........    #
#    ............................................          .......    #
# ..#%#  #%#   #%#..    %%%%%%%%%%%%%  ......#%#    #%# ..#%#.        #
# ..#%#  #%#   #%#..           ...#%#     %%%%%%    #%# ..#%#.        #
# ..#%#            .           ...#%#               #%# ..#%#.        #
# ..#%#  %%%%%%%%%%%%%%        ...#%#%%%%%%%%%%     #%# ..#%#%%%%%    #
# ...............................................   #%# ..........    #
#   H............................................          .......    #
#######################################################################